                                                                                                         
                                                                                                         
                                                                                                         
                                                                                                         
                                                                                                         
                           .....................................                                         
                           .....................................                                         
                           .....................................                                         
                           .....................................                                         
                           .....................................                                         
                           .....                           .....                                         
                           .....                           .....                                         
                           .....                           .....                                         
                           .....                           .....                                         
                           .....                           .....                                         
                           .....                           .....                                         
                           .....                           .....                                         
................................                           .....                                         
................................                           .....                                         
................................                           .....                                         
................................                           .....                                         
................................                           .....                                         
                                                           .....                                         
                                                           .....                                         
                                                           .....                                         
                                                           .....                                         
                                                           .....                                         
                                                           .....                                         
                                                           .....                                         
                           .....................................                                         
                           .....................................                                         
                           .....................................                                         
                           .....................................                                         
                           .....................................                                         
                           .....                                                                         
                           .....                                  # # # #       # # # # #       # # # #  
                           .....                                   #####         #######         #####   
                           .....                                   # # #         # ### #         # # #   
                           .....                                   #####         #######         #####   
                           .....                                   ##### # # # # # ### # # # # # #####   
                           .....                                   ################# #################   
                           .....................................   #####|||||||||##...##|||||||||#####   
                           .....................................   ###############.....###############   
                           .....................................   #####|||||||||#.....#|||||||||#####   
                           .....................................   #####|||||||||#.....#|||||||||#####   
                           .....................................   ###############.....###############   
                                                           .....                  .....                  
                                                           ............................                  
                                                           ............................                  
                                                           ............................                  
                                                           ............................                  
                                                           ............................                  
                                                                                                         
                                                                                                         